10,9,13,1,2,58,1,10,11,25,64,6,17,73,1,3,4,16,33,4,7,39,1,3,5,16,17,2,3,9,0,2,0,3,1,0,1,1,0,0,0,1,0,0,0,1,0,1,1,2,0,1,1,0,0,0,0,0,0,0,0,0,0,0
244,250,253,29,33,1,18,255,255,255,255,254,248,153,132,255,255,255,255,236,115,3,4,255,255,255,255,50,5,0,0,210,200,215,175,2,0,0,0,21,33,120,33,0,0,0,0,21,21,74,41,1,0,0,0,0,0,0,0,0,0,0,0,0
7,12,121,2,41,255,255,255,255,229,255,57,213,255,255,255,255,156,238,13,10,255,255,250,255,123,222,6,4,244,252,104,252,4,1,0,0,2,0,0,1,0,0,0,0,1,1,1,8,0,0,0,0,0,0,0,0,0,0,0,0,0,0,0
1,58,192,54,151,255,255,255,255,255,255,255,255,255,255,255,255,255,252,253,204,255,255,254,255,255,251,240,106,254,252,198,225,224,83,38,1,44,1,1,0,1,0,1,0,11,2,13,3,2,0,4,0,0,0,0,0,0,0,0,0,0,0,0
32,250,255,255,255,255,255,107,255,255,255,255,255,255,255,107,255,255,255,255,255,255,255,8,255,255,255,255,255,255,255,4,254,255,255,254,255,229,16,0,1,22,7,153,175,55,6,0,25,74,12,98,27,0,0,0,0,0,0,0,0,0,0,0
254,255,255,255,255,255,255,255,255,255,255,255,255,255,255,255,255,255,255,255,255,255,255,255,255,255,255,255,255,255,255,255,255,255,255,255,255,255,252,254,253,251,255,161,254,253,247,255,255,255,255,254,253,170,0,1,0,0,0,0,0,0,0,0
0,19,143,254,31,250,68,11,255,133,110,255,255,254,87,3,249,29,0,255,13,164,1,0,81,1,0,255,110,84,15,0,173,8,3,244,27,1,0,0,0,0,0,1,0,0,0,0,0,0,0,0,0,0,0,0,0,0,0,0,0,0,0,0
0,131,4,255,2,241,255,0,1,249,30,255,253,255,255,4,0,11,0,255,14,195,244,2,0,175,5,255,219,252,255,106,139,251,214,255,252,137,0,0,0,0,0,19,0,0,0,0,0,0,0,63,0,0,0,0,0,0,0,0,0,0,0,0
24,246,255,255,255,255,255,255,255,255,255,255,255,255,255,255,255,255,255,255,255,255,255,255,255,255,255,255,255,255,255,255,255,255,255,255,255,223,0,0,0,0,0,0,11,1,0,0,0,0,0,0,0,0,0,0,0,0,0,0,0,0,0,0
251,255,255,0,0,0,0,255,255,255,255,117,1,0,0,255,255,255,255,0,0,0,0,253,255,255,255,1,0,0,0,255,255,255,255,164,2,0,0,0,0,0,1,0,0,0,0,0,0,0,0,0,0,0,0,0,0,0,0,0,0,0,0,0
4,5,247,15,8,255,255,255,255,253,255,239,105,255,255,255,255,21,60,0,0,254,255,255,255,22,102,5,0,255,255,255,255,232,235,78,0,21,0,0,0,0,0,0,0,0,0,0,0,0,0,0,0,0,0,0,0,0,0,0,0,0,0,0
0,1,1,0,0,255,255,123,255,253,88,147,0,255,152,4,142,39,0,6,0,235,4,0,6,1,0,0,0,153,6,1,136,51,1,49,0,0,0,0,0,0,0,0,0,0,0,0,0,0,0,0,0,0,0,0,0,0,0,0,0,0,0,0
3,239,255,255,255,255,255,0,255,255,255,255,255,255,255,0,255,255,255,255,255,254,245,0,66,251,255,255,255,254,255,0,252,255,255,255,255,66,0,0,0,0,0,2,2,0,0,0,0,0,0,0,0,0,0,0,0,0,0,0,0,0,0,0
255,255,255,255,255,255,255,255,255,255,255,255,255,255,255,255,255,255,255,255,255,255,255,255,255,255,255,255,255,255,255,255,255,255,255,255,255,253,214,254,252,212,249,5,215,3,1,1,1,0,2,0,0,0,0,0,0,0,0,0,0,0,0,0
0,7,97,254,23,230,4,0,254,2,1,255,109,55,2,0,65,1,0,252,1,5,0,0,0,0,0,251,5,20,0,0,11,1,0,249,11,2,0,0,0,0,0,3,0,0,0,0,0,0,0,0,0,0,0,0,0,0,0,0,0,0,0,0
0,133,30,255,61,254,255,3,3,227,6,255,191,254,252,3,2,34,0,255,88,117,203,0,0,0,0,255,34,220,254,3,3,33,2,255,216,231,242,61,69,104,11,255,135,147,201,1,0,0,0,211,3,0,0,0,0,0,0,0,0,0,0,0
36,253,255,255,255,255,255,255,255,255,255,255,255,255,255,255,255,255,255,254,255,255,254,249,254,251,255,254,255,255,255,255,255,255,255,255,255,255,250,235,253,240,245,105,254,191,62,7,8,4,12,4,90,1,0,0,0,0,0,0,0,0,0,0
251,255,255,0,0,0,0,255,255,255,255,1,0,0,0,251,254,255,255,0,0,0,0,45,237,254,255,0,0,0,0,251,255,255,255,5,4,0,0,255,255,255,255,8,0,0,0,4,69,110,237,0,0,0,0,47,109,52,22,0,0,0,0,0
7,12,253,142,12,255,255,255,255,241,250,51,0,249,254,254,255,5,4,0,0,64,40,94,255,0,7,0,0,255,255,255,255,134,243,19,5,255,255,255,255,132,6,0,0,16,12,21,213,0,0,0,0,79,146,14,244,1,0,0,0,0,0,0
0,0,0,0,0,94,1,0,41,14,0,0,0,6,0,0,0,0,0,0,0,0,0,0,0,0,0,0,0,240,170,24,241,90,30,80,1,254,218,176,251,170,7,15,0,4,0,0,0,0,0,1,0,66,134,86,242,190,53,69,0,0,0,0
1,238,255,255,255,255,255,0,255,255,255,255,255,247,218,0,56,191,252,255,254,3,0,0,0,4,191,255,255,254,255,0,253,255,255,255,255,255,255,2,255,255,255,255,255,151,9,0,2,35,215,254,255,247,234,0,251,232,246,217,165,0,0,0
253,255,255,254,255,255,255,255,255,255,255,255,255,255,255,255,255,255,255,252,255,255,180,254,255,251,255,11,255,255,255,255,255,255,255,255,255,255,255,255,255,255,255,255,255,255,253,255,255,255,255,247,255,255,255,255,255,255,255,255,255,119,4,4
0,14,221,254,35,213,28,0,255,36,3,253,22,0,0,0,0,0,0,52,0,0,0,0,0,0,0,89,0,16,6,1,238,8,17,255,226,155,49,6,248,89,1,234,1,0,0,0,0,0,0,97,0,2,0,0,1,11,1,251,57,0,0,0
0,224,137,255,217,255,255,187,252,254,206,255,254,254,211,12,0,2,0,255,26,49,1,0,0,0,0,251,0,194,255,1,4,208,165,255,248,254,255,212,209,252,38,255,176,88,31,1,0,2,0,254,53,90,36,2,2,68,14,255,245,12,0,0
21,250,255,255,255,255,255,255,255,255,255,255,255,252,77,10,7,29,12,14,212,25,0,0,0,11,251,219,255,255,255,255,255,255,255,255,255,255,255,255,255,255,255,214,255,154,1,6,12,28,96,32,235,203,21,120,249,254,255,244,253,7,0,0
254,255,255,144,196,1,2,255,255,255,255,174,0,0,0,0,0,1,1,0,0,0,0,0,0,2,223,0,0,0,0,255,255,255,255,163,69,0,0,255,255,255,255,3,0,0,0,0,1,10,38,0,0,0,0,2,45,231,238,134,19,0,0,0
6,26,254,248,247,255,255,255,255,255,131,13,0,1,0,0,0,0,0,0,0,0,0,0,11,0,0,0,0,255,255,255,255,231,255,237,234,255,255,255,255,183,2,0,0,1,0,0,73,0,0,0,0,0,0,3,247,1,0,5,0,0,0,0
0,6,4,14,5,255,236,196,255,245,0,4,0,0,0,0,0,0,0,0,0,0,0,0,0,0,0,0,0,198,243,6,182,189,129,11,0,249,76,2,24,4,0,0,0,0,0,0,0,0,0,0,0,0,0,0,0,0,0,0,0,0,0,0
18,253,255,255,255,255,255,10,255,255,255,255,254,0,0,0,0,0,0,8,34,0,0,0,0,0,129,255,255,255,255,2,255,255,255,255,255,255,255,0,255,255,255,254,253,4,0,0,0,5,64,225,237,4,0,0,2,50,157,209,60,0,0,0
254,255,255,255,255,255,255,255,255,255,255,255,255,244,21,32,76,37,240,13,254,246,227,251,254,255,255,203,255,255,255,255,255,255,255,255,255,255,255,255,255,255,255,255,255,255,246,255,255,255,255,248,255,255,254,255,255,255,255,254,250,7,0,1
0,25,221,255,225,237,17,3,254,99,0,233,1,0,0,0,0,0,0,1,0,0,0,0,0,0,0,7,0,4,1,1,245,3,27,255,223,73,3,0,45,1,0,167,0,1,0,0,0,0,0,174,2,2,0,0,0,0,0,118,0,0,0,0
0,133,12,255,193,252,255,105,166,205,2,255,138,187,217,2,1,12,3,255,112,164,61,0,0,0,0,254,4,218,255,81,100,254,222,255,255,255,255,113,84,214,5,255,171,247,254,76,43,242,126,255,242,254,254,109,49,114,2,255,152,2,0,0
31,249,255,255,255,255,255,255,255,255,255,218,255,211,180,108,139,181,228,108,254,142,2,0,0,5,74,170,255,255,255,255,255,255,255,255,255,255,255,251,255,254,254,250,255,253,241,248,255,254,255,255,255,255,245,194,245,246,77,135,211,1,0,0
245,254,255,6,1,0,0,255,255,255,255,0,0,0,0,193,249,255,254,0,0,0,0,0,0,0,1,0,0,0,0,253,255,255,255,45,1,0,0,234,253,255,255,0,0,0,0,254,255,255,255,223,35,0,0,243,244,252,195,37,6,0,0,0
7,5,228,46,20,255,255,255,255,150,18,0,0,142,244,249,255,1,0,0,0,1,0,0,0,0,0,0,0,125,252,255,255,22,88,27,0,234,108,247,255,1,0,0,0,226,254,254,255,78,195,119,1,152,11,73,253,2,0,0,0,0,0,0
0,0,0,0,0,198,5,1,133,3,0,0,0,64,15,3,0,0,0,0,0,0,0,0,0,0,0,0,0,0,0,0,0,0,0,0,0,0,0,0,0,0,0,0,0,23,1,1,10,41,1,111,0,70,0,0,0,0,0,1,0,0,0,0
1,173,254,255,255,255,255,0,252,254,255,255,255,231,254,0,8,183,173,247,235,2,0,0,0,0,0,7,25,1,48,0,1,177,245,255,255,104,2,0,4,109,251,255,255,236,239,0,235,255,255,255,255,220,4,0,5,35,9,64,6,0,0,0
251,255,255,252,255,255,255,255,255,255,255,252,255,255,255,255,255,255,255,243,255,251,146,245,161,81,188,0,168,35,151,254,254,242,255,5,250,153,18,255,255,255,255,236,255,255,254,255,255,255,255,255,255,254,194,255,255,254,254,243,219,0,0,0
1,14,174,251,29,148,7,0,223,11,0,166,1,2,2,1,12,0,1,118,0,0,0,0,0,0,0,0,0,0,0,0,8,0,0,29,0,2,0,0,2,0,0,203,0,1,0,0,1,0,0,232,1,0,0,0,0,0,0,16,0,0,0,0
0,144,60,255,147,251,255,54,159,231,40,255,87,253,255,120,12,187,41,255,200,233,182,1,0,0,0,217,1,123,255,11,12,126,101,255,124,245,255,3,4,63,36,255,198,240,244,2,0,1,0,253,19,4,0,0,0,0,0,212,5,0,0,0
28,244,255,255,255,255,255,255,255,255,255,142,255,255,255,255,254,255,255,254,255,254,109,10,167,47,201,40,255,253,255,250,255,251,255,247,255,255,255,241,255,255,255,254,255,255,243,187,215,207,146,105,250,168,2,4,25,39,4,6,7,0,0,0
253,255,255,80,29,0,0,255,255,255,255,0,0,0,0,254,255,255,255,63,1,0,0,47,199,204,248,0,0,0,1,255,255,255,255,9,32,0,1,255,255,255,255,52,0,0,0,80,69,113,107,0,0,0,0,2,15,42,33,1,0,0,0,0
6,26,253,211,243,255,255,255,255,215,35,0,0,243,255,255,255,20,109,2,0,39,1,7,252,0,1,0,0,251,255,255,255,167,254,39,11,255,255,255,255,124,169,22,0,21,1,2,175,0,0,0,0,0,0,0,3,0,0,0,0,0,0,0
0,15,20,19,17,255,238,44,251,77,0,1,0,32,9,1,3,3,0,1,0,1,0,0,0,0,0,2,0,254,255,234,253,234,197,56,1,254,250,32,54,52,1,7,0,0,0,0,0,0,0,0,0,0,0,0,0,0,0,0,0,0,0,0
14,252,255,255,255,255,255,0,255,255,255,255,255,228,253,0,180,250,255,255,255,223,15,0,12,74,220,255,255,255,255,11,255,255,255,255,255,255,255,0,253,255,255,255,254,63,0,0,0,0,0,13,54,0,0,0,0,0,0,1,0,0,0,0
254,255,255,255,255,255,255,255,255,255,255,252,255,255,255,255,255,255,255,255,255,255,254,255,255,255,255,253,255,255,255,255,255,255,255,255,255,255,255,255,255,255,255,255,255,254,188,239,199,100,236,50,238,50,14,162,126,109,59,32,4,0,0,0
0,19,182,254,179,221,4,0,113,6,0,247,6,5,2,0,24,0,0,229,3,3,0,0,0,0,0,144,0,17,1,3,92,2,1,248,7,25,0,0,8,0,0,228,3,0,0,0,0,0,0,0,0,0,0,0,0,0,0,0,0,0,0,0
0,181,86,255,219,254,255,5,5,146,5,255,61,228,254,4,2,55,8,255,238,197,98,0,0,0,0,254,5,49,59,4,0,3,0,255,65,236,144,38,3,42,1,255,207,93,0,1,0,0,0,20,0,0,0,0,0,0,0,2,0,0,0,0
54,251,255,255,255,255,255,255,255,255,255,254,255,255,255,255,255,255,255,255,255,255,221,62,235,240,249,251,255,255,253,250,255,254,254,253,255,255,246,227,232,178,123,151,253,71,0,0,0,0,0,0,0,0,0,0,0,0,0,0,0,0,0,0
248,252,253,7,2,0,0,255,255,255,255,3,0,0,0,254,255,255,255,140,6,0,0,207,218,253,239,1,0,0,0,7,12,94,66,0,0,0,0,10,26,55,19,0,0,0,0,0,0,0,0,0,0,0,0,0,0,0,0,0,0,0,0,0
4,7,246,171,213,255,255,255,255,115,241,7,1,254,255,255,255,59,129,10,0,62,0,1,119,0,0,0,0,0,0,0,0,0,0,0,0,0,0,0,0,0,0,0,0,0,0,0,0,0,0,0,0,0,0,0,0,0,0,0,0,0,0,0
0,1,0,0,0,249,172,26,239,220,21,84,0,242,7,7,111,18,0,98,0,1,0,0,0,0,0,0,0,0,0,0,0,0,0,0,0,0,0,0,0,0,0,0,0,0,0,0,0,0,0,0,0,0,0,0,0,0,0,0,0,0,0,0
3,202,254,255,255,255,255,0,255,255,255,255,255,254,251,0,175,252,255,255,255,67,0,0,0,0,0,0,0,0,0,0,0,0,0,0,0,0,0,0,0,0,0,0,0,0,0,0,0,0,0,0,0,0,0,0,0,0,0,0,0,0,0,0
253,254,255,248,255,255,255,255,255,255,255,255,255,255,255,255,255,255,255,255,255,253,24,175,13,9,7,0,0,0,0,0,0,0,0,0,0,0,0,0,0,0,0,0,0,0,0,0,0,0,0,0,0,0,0,0,0,0,0,0,0,0,0,0
0,3,15,173,1,33,0,0,40,0,0,252,4,2,0,0,0,0,0,113,0,0,0,0,0,0,0,0,0,0,0,0,0,0,0,0,0,0,0,0,0,0,0,0,0,0,0,0,0,0,0,0,0,0,0,0,0,0,0,0,0,0,0,0
1,42,2,251,17,188,248,4,1,29,0,255,126,211,6,0,0,0,0,255,1,0,0,0,0,0,0,0,0,0,0,0,0,0,0,0,0,0,0,0,0,0,0,0,0,0,0,0,0,0,0,0,0,0,0,0,0,0,0,0,0,0,0,0
12,184,255,251,255,255,255,255,255,255,255,254,255,255,154,77,53,75,5,7,6,0,0,0,0,0,0,0,0,0,0,0,0,0,0,0,0,0,0,0,0,0,0,0,0,0,0,0,0,0,0,0,0,0,0,0,0,0,0,0,0,0,0,0
205,200,77,0,0,0,0,211,228,254,235,0,0,0,0,1,0,9,0,0,0,0,0,0,0,0,0,0,0,0,0,0,0,0,0,0,0,0,0,0,0,0,0,0,0,0,0,0,0,0,0,0,0,0,0,0,0,0,0,0,0,0,0,0
2,0,0,0,0,3,3,129,253,0,0,0,0,0,0,0,0,0,0,0,0,0,0,0,0,0,0,0,0,0,0,0,0,0,0,0,0,0,0,0,0,0,0,0,0,0,0,0,0,0,0,0,0,0,0,0,0,0,0,0,0,0,0,0
0,0,0,0,0,0,0,0,0,0,0,0,0,0,0,0,0,0,0,0,0,0,0,0,0,0,0,0,0,0,0,0,0,0,0,0,0,0,0,0,0,0,0,0,0,0,0,0,0,0,0,0,0,0,0,0,0,0,0,0,0,0,0,0
1,1,0,7,65,1,0,0,0,2,1,79,56,0,0,0,0,0,0,0,0,0,0,0,0,0,0,0,0,0,0,0,0,0,0,0,0,0,0,0,0,0,0,0,0,0,0,0,0,0,0,1,4,0,0,0,0,0,0,0,0,0,0,0
134,44,35,0,61,5,13,71,229,152,222,13,188,8,3,11,31,3,6,0,0,0,0,0,0,0,0,0,0,0,0,0,0,0,0,0,0,0,0,0,0,0,1,0,23,1,12,27,245,181,251,217,252,94,33,6,3,0,0,0,0,0,0,0
2,0,0,0,0,0,0,0,0,0,0,2,0,0,0,0,0,0,0,0,0,0,0,0,0,0,0,0,0,0,0,0,0,0,0,0,0,0,0,0,0,0,0,0,0,0,0,0,1,0,1,7,2,0,0,0,0,0,0,0,0,0,0,0
11,2,0,1,0,0,0,0,1,1,1,83,18,5,3,2,3,0,1,13,3,0,0,0,0,0,0,0,0,0,0,0,0,0,0,0,0,0,0,0,1,0,1,5,3,1,3,2,6,4,11,94,45,7,2,2,1,0,0,1,0,0,0,1
