10,0,1,0,255,1,248,1,209,0,0,254,199,0,4,0,0,0,255,1,254,130,255,237,254,0,151,1,252,229,0,0,1,0,102,0,242,0,215,0,4,39,0,249,1,2,255,2,255,119,1,117,0,17,1,13,255,4,65,0,253,251,114,248
253,36,254,195,255,255,253,0,255,0,255,255,0,255,255,1,255,0,255,255,1,255,0,4,255,3,14,247,254,3,0,255,10,0,0,0,6,0,0,0,255,0,254,233,0,4,0,0,0,0,255,0,0,184,0,254,255,0,2,255,18,247,0,255
187,1,249,0,252,213,0,4,255,111,255,245,255,0,0,194,7,236,0,0,255,0,249,240,35,255,0,254,255,255,0,255,255,255,234,254,255,82,255,255,250,253,18,255,255,1,0,255,0,255,0,255,255,0,0,0,0,2,0,255,0,255,0,251
73,255,1,0,0,159,255,0,253,255,253,0,223,0,255,164,217,255,11,0,0,255,0,7,0,254,255,0,0,79,87,255,255,136,0,0,0,255,255,0,255,255,255,0,0,0,4,2,255,255,255,0,255,2,255,0,253,0,0,255,0,0,0,1
253,0,242,206,255,0,0,255,10,247,255,255,255,248,191,255,255,0,255,249,255,0,0,255,251,255,255,1,229,76,0,255,255,202,255,255,11,255,1,255,255,0,255,252,255,244,255,249,0,255,255,0,0,231,251,255,0,232,0,21,255,1,10,255
3,110,247,67,119,26,253,255,4,226,255,0,1,0,0,255,4,0,255,0,255,255,0,0,34,0,255,50,33,255,0,0,250,0,255,0,0,255,255,254,252,0,255,255,255,255,252,0,255,255,255,0,255,234,1,54,255,0,255,0,255,0,0,174
229,247,1,255,1,0,251,0,0,0,254,0,255,1,254,255,255,255,0,0,255,255,164,255,255,0,0,0,255,255,255,255,0,0,255,255,0,254,14,255,0,255,254,255,3,255,1,0,0,0,255,255,188,255,255,255,255,0,0,0,0,255,6,240
193,0,0,0,255,255,254,0,0,100,1,0,0,0,0,234,0,4,255,0,0,255,255,0,12,0,0,0,0,255,255,0,0,251,255,0,0,255,255,214,1,255,0,0,0,255,255,0,0,0,0,0,0,255,0,19,0,1,0,0,0,255,255,248
255,0,255,109,0,0,0,255,0,74,255,0,255,0,0,255,5,0,255,0,226,0,255,104,255,0,255,255,2,0,255,255,255,250,255,0,255,0,44,0,255,0,255,255,255,3,255,255,255,253,255,243,0,0,0,171,255,255,255,216,0,0,0,254
255,0,8,0,243,0,252,0,255,0,254,255,255,255,254,247,255,255,255,255,88,0,0,254,255,67,0,255,246,0,1,255,255,0,255,255,0,255,255,255,139,1,255,249,0,255,0,255,255,0,0,255,0,0,0,1,255,232,11,0,255,0,255,255
0,255,255,0,255,46,253,29,0,255,0,2,255,0,0,255,225,255,0,0,255,0,3,0,0,255,0,48,255,19,21,0,255,0,0,8,240,255,106,255,0,255,0,0,27,0,255,0,241,0,2,0,0,0,255,1,255,0,0,0,192,6,0,1
255,0,255,0,0,182,1,0,0,0,0,0,255,255,0,255,255,124,0,0,254,0,0,0,0,5,255,0,0,255,255,212,233,255,255,0,0,0,123,0,0,0,255,245,0,0,255,0,0,89,255,0,0,0,77,167,10,0,217,0,255,4,253,38
255,8,255,0,0,128,0,255,255,216,255,65,255,255,255,0,255,183,255,255,1,0,133,255,0,248,255,255,255,0,0,0,254,3,255,0,255,0,0,210,255,255,193,105,255,0,255,255,0,0,255,2,255,255,255,0,201,255,0,255,255,255,0,253
103,7,254,254,0,255,0,0,0,151,0,254,0,0,253,255,255,255,255,0,255,10,1,255,0,0,0,0,255,255,253,255,255,0,255,0,0,255,255,0,255,0,0,255,255,255,0,0,255,0,255,0,20,0,255,255,254,0,255,0,255,254,0,255
0,0,255,254,29,255,0,0,255,255,255,0,255,29,0,254,255,252,255,255,21,255,0,2,255,0,144,0,0,255,0,255,0,2,255,238,255,255,255,255,0,159,255,0,255,255,255,255,255,255,255,0,255,255,255,255,255,255,0,0,0,82,202,193
198,0,255,0,4,16,0,253,0,0,0,0,0,0,242,226,0,255,1,0,0,0,196,191,255,255,255,0,0,255,255,50,114,255,0,206,0,193,255,255,255,0,255,0,0,255,0,0,0,255,50,198,0,255,255,255,0,0,0,0,0,255,255,253
253,1,248,0,255,254,112,255,255,253,0,0,0,0,70,0,255,255,250,255,255,0,255,255,255,0,255,0,255,250,0,0,255,252,255,255,255,255,255,4,6,0,255,243,255,255,169,0,255,8,255,0,0,254,255,255,0,158,2,255,255,0,0,83
198,0,1,0,215,0,0,255,255,0,0,79,0,0,255,0,241,0,0,0,255,0,0,255,2,0,0,0,0,0,255,0,255,255,255,1,0,0,255,76,255,0,0,0,0,0,0,6,8,255,0,0,0,254,185,255,40,84,255,255,6,111,0,139
168,0,0,0,255,0,255,250,255,255,255,0,255,255,255,8,255,255,0,0,36,145,255,0,162,0,255,248,255,255,0,159,2,0,0,0,1,70,245,0,254,0,0,0,255,132,219,14,255,0,255,232,255,0,255,0,254,17,0,255,255,0,255,6
253,255,0,0,0,0,0,255,2,255,249,0,0,255,251,0,0,255,0,0,0,0,254,0,255,255,255,0,0,255,255,255,0,255,255,0,0,0,255,255,0,255,255,0,0,0,0,20,0,255,255,0,8,0,255,0,255,255,255,0,0,255,255,77
255,239,255,255,255,0,0,255,255,176,255,0,255,0,255,255,175,0,255,255,255,4,239,255,255,45,255,239,255,255,255,255,255,0,255,255,255,0,0,255,255,0,255,255,255,255,0,255,255,1,255,0,255,68,0,1,255,255,255,255,0,0,101,3
231,0,255,5,1,255,0,215,0,0,255,255,255,56,0,0,0,0,255,0,255,0,0,0,8,0,0,0,0,251,0,0,255,0,0,4,26,255,0,0,0,0,0,0,181,0,255,0,255,255,0,0,255,255,255,255,255,0,255,0,255,215,0,215
250,13,0,0,254,0,0,255,254,255,0,0,2,255,194,255,0,181,245,0,254,255,0,255,0,0,158,0,12,0,20,0,0,0,255,0,0,255,255,255,1,0,255,0,255,255,0,255,0,255,255,0,250,0,253,194,2,59,255,0,0,0,255,14
28,0,0,0,255,255,0,255,0,66,0,0,239,243,255,255,0,255,0,0,0,255,0,225,250,44,11,0,255,71,255,0,0,0,255,0,255,255,83,255,0,0,0,0,0,10,255,1,1,0,0,0,255,250,185,0,255,255,0,0,0,0,0,0
255,0,255,255,255,0,255,255,255,0,0,255,1,51,0,255,0,183,255,0,244,0,255,254,255,0,0,241,254,42,255,252,255,255,255,0,255,0,0,255,16,0,0,0,255,80,255,255,0,0,255,0,255,0,60,255,255,255,0,255,255,255,0,0
255,0,0,0,255,0,0,0,255,0,0,0,193,0,255,0,0,0,255,255,0,255,0,2,255,0,0,0,255,0,6,0,0,0,235,255,31,0,0,0,255,35,0,0,0,0,253,255,32,0,255,0,255,0,0,200,0,0,255,0,255,246,249,215
255,254,255,0,255,0,255,254,20,0,198,3,255,2,253,0,229,255,0,0,14,12,0,0,35,9,255,0,255,17,255,0,3,255,7,1,255,255,255,255,255,255,8,27,4,255,0,255,255,255,0,0,255,255,15,255,219,255,0,3,255,0,250,233
255,0,255,0,0,42,0,0,1,255,0,0,4,255,255,0,255,255,255,2,248,0,0,0,255,116,0,0,255,233,0,0,101,255,255,217,255,0,255,0,74,0,255,0,0,0,1,0,246,0,0,0,0,255,0,255,255,255,255,0,0,0,255,0
254,0,0,255,115,0,0,132,2,13,255,0,7,2,255,255,0,0,233,0,255,255,255,255,1,0,255,0,255,255,255,243,255,249,0,2,0,0,76,255,255,255,1,0,255,253,0,0,113,255,255,255,12,0,246,14,0,255,255,199,255,2,1,229
255,0,0,0,255,255,0,244,255,0,255,248,255,255,0,0,17,0,3,2,255,0,0,3,255,211,221,0,255,255,255,255,31,0,3,0,255,232,0,214,0,6,255,0,255,255,255,9,0,255,0,0,255,255,0,255,0,0,3,1,255,1,0,15
176,0,255,4,255,255,0,32,0,255,255,0,255,255,255,84,255,0,255,0,255,0,255,0,230,0,255,254,250,1,0,255,0,0,255,0,255,255,0,255,244,255,255,0,255,255,0,255,0,0,196,255,0,255,163,0,253,0,252,255,0,255,0,247
253,1,214,0,30,18,255,142,0,51,0,2,255,255,0,0,0,0,80,0,0,0,4,0,255,0,255,0,254,255,248,255,0,253,0,0,4,0,255,0,0,255,255,0,0,11,0,255,0,0,0,0,238,0,0,1,0,255,0,0,0,0,255,138
254,0,0,255,255,0,244,18,255,0,0,255,0,0,252,255,255,163,255,0,2,0,0,255,0,0,255,0,255,1,0,255,255,22,255,0,198,0,255,0,255,27,255,105,254,175,23,255,255,255,255,0,48,0,176,0,255,255,252,222,255,255,255,255
235,0,1,0,255,0,0,0,255,255,0,255,0,0,0,221,255,0,0,0,6,252,1,0,0,0,255,100,255,1,255,0,254,0,255,239,255,216,4,0,255,0,255,255,255,0,228,0,0,0,0,255,250,0,115,0,255,255,32,255,0,255,0,156
1,255,243,0,3,0,255,0,255,255,2,255,255,0,255,12,255,228,255,1,255,0,255,0,0,255,255,250,255,0,255,255,217,255,255,255,61,126,255,253,0,83,255,0,252,252,0,255,255,0,0,0,0,0,0,14,255,0,0,255,0,0,238,3
13,255,10,0,73,0,0,0,255,0,255,0,0,157,0,252,64,253,255,0,201,0,0,0,253,0,255,0,0,0,255,0,255,0,254,0,0,1,64,0,0,0,255,0,0,240,9,255,0,255,255,0,0,255,32,0,0,1,255,0,2,255,0,0
1,116,255,1,255,0,255,255,255,0,255,0,255,255,255,255,0,255,6,0,255,255,0,246,0,244,255,0,255,0,255,255,0,0,200,0,255,0,255,0,252,255,5,0,0,21,255,255,255,192,255,0,255,0,0,255,255,255,0,255,255,0,0,255
255,0,2,0,255,158,0,233,0,0,255,0,6,0,0,255,0,0,0,0,0,0,0,0,0,0,255,0,0,244,105,236,0,0,184,255,255,0,0,70,0,249,0,0,0,255,0,234,232,0,0,255,0,191,0,242,255,0,28,255,255,0,0,250
9,255,255,73,255,255,242,0,255,0,44,0,255,255,36,255,0,0,255,0,255,255,255,255,255,80,0,0,251,222,0,0,0,0,255,0,255,47,0,0,255,255,22,9,0,159,0,0,255,0,255,0,0,255,0,26,255,0,255,213,0,0,255,30
1,0,0,0,255,0,255,255,0,0,35,0,0,252,243,0,0,0,0,0,25,0,0,238,0,255,0,0,0,255,22,251,255,254,251,0,0,47,0,0,0,0,0,0,0,252,255,0,0,0,0,62,60,210,0,184,255,91,0,0,0,244,255,1
251,0,255,0,220,0,255,12,2,0,0,0,255,0,254,255,255,0,255,0,4,1,255,0,255,0,255,255,255,0,212,0,255,0,57,0,255,255,255,255,255,33,255,255,104,0,255,11,255,233,255,255,255,0,0,0,255,62,255,0,104,255,252,71
255,254,13,255,255,0,255,0,0,0,0,254,0,59,0,0,254,0,0,0,3,0,0,0,0,0,255,255,255,0,0,1,28,0,0,0,3,255,0,0,20,0,0,255,249,255,0,254,0,0,0,255,0,255,0,254,28,0,0,255,0,0,0,255
254,0,255,255,255,0,255,86,246,250,44,0,255,255,255,255,0,255,248,0,255,255,255,255,0,0,0,255,253,0,255,255,0,255,255,94,255,5,255,0,0,255,6,0,255,255,31,244,255,255,0,255,255,0,255,255,255,93,0,0,0,0,131,104
255,0,255,0,0,255,255,0,0,252,255,0,0,242,0,255,0,255,253,0,0,0,77,255,251,0,244,50,0,0,0,255,255,255,255,0,0,250,0,101,255,0,0,0,0,255,255,255,44,255,255,0,0,0,252,255,255,0,7,0,1,96,0,1
254,255,255,0,255,254,255,255,254,255,255,255,255,0,255,255,255,3,255,0,255,0,255,0,87,248,0,0,0,255,0,0,0,255,0,0,2,255,16,255,255,254,255,255,0,0,255,255,0,0,0,251,254,255,42,255,0,255,0,255,255,255,98,255
252,251,255,0,255,0,0,4,0,0,1,0,255,16,0,2,255,0,0,1,0,255,222,0,0,0,255,252,0,255,255,0,255,251,255,0,249,255,0,248,0,0,254,0,255,255,0,255,34,128,0,0,255,0,0,40,11,141,0,255,255,255,40,7
219,255,17,2,0,255,254,0,252,0,255,11,255,255,0,255,255,0,246,0,70,0,0,254,255,1,255,0,0,0,255,0,0,254,205,255,0,255,255,0,255,0,255,0,0,250,255,255,61,255,175,0,226,240,251,255,6,0,255,0,54,0,255,0
255,0,139,0,22,172,255,0,0,0,250,0,0,255,232,0,0,0,0,0,0,0,255,255,0,255,0,0,0,241,0,255,0,255,0,0,0,0,0,255,55,253,92,0,0,255,0,6,0,255,0,0,0,0,0,255,0,0,255,210,0,0,255,0
244,0,255,255,0,0,255,255,255,0,255,0,0,0,255,255,255,0,255,255,255,255,255,0,255,0,41,6,255,0,253,255,255,255,255,0,255,0,255,249,255,0,255,255,0,0,255,255,255,255,0,0,255,0,255,255,255,255,255,255,1,1,255,255
255,0,0,3,255,0,4,2,255,0,255,253,53,0,233,0,0,0,255,255,255,0,0,253,0,0,60,255,255,255,0,8,255,0,0,0,0,255,249,0,255,0,0,241,54,0,255,255,233,0,0,0,255,0,255,255,255,0,231,0,254,0,255,248
201,14,255,0,255,0,255,54,255,255,0,0,0,0,255,255,234,255,0,254,0,255,133,88,255,1,122,0,255,252,255,255,0,20,0,0,255,0,0,255,0,0,0,0,255,255,255,2,147,255,255,0,253,255,255,255,0,254,251,0,255,0,0,253
66,11,0,0,255,0,159,0,254,3,255,0,0,0,86,255,0,255,255,255,2,0,0,255,255,255,255,0,0,0,0,0,0,0,255,0,114,255,0,0,0,255,255,0,254,255,255,246,255,254,194,0,0,255,255,0,0,0,255,0,20,4,0,88
35,172,255,0,9,255,189,47,255,255,4,255,255,255,0,244,255,0,0,0,255,0,1,200,255,255,228,255,255,0,0,255,255,255,255,255,31,41,245,255,0,1,249,255,255,249,254,255,0,255,255,247,255,0,255,255,255,255,1,0,255,2,0,255
254,255,255,0,255,1,255,87,0,43,255,255,255,0,0,255,0,0,0,0,0,0,15,0,251,255,0,0,251,255,217,0,245,0,255,0,255,255,0,0,255,0,1,0,255,0,255,255,255,213,255,0,0,92,0,255,0,0,1,0,255,255,0,254
99,255,1,255,0,0,41,255,255,0,0,0,232,0,6,0,1,0,255,255,255,255,0,0,255,0,255,0,1,255,0,255,254,0,255,255,0,255,255,5,2,0,255,255,0,255,6,0,0,0,255,216,255,255,255,255,0,255,255,0,187,255,0,62
255,19,1,0,255,255,255,0,0,132,0,0,0,255,255,255,0,255,255,0,0,255,0,1,0,236,255,0,255,255,200,143,0,242,0,62,0,255,0,0,0,0,0,255,68,255,255,104,255,247,0,0,0,136,0,243,3,0,0,247,0,14,0,0
244,1,17,255,0,151,255,255,255,0,0,255,255,0,255,27,255,0,1,255,255,0,255,255,255,0,255,0,255,53,255,0,255,0,255,240,255,0,255,255,255,0,150,0,0,0,255,255,255,10,255,0,255,0,0,255,255,0,255,39,255,0,10,255
168,0,70,0,0,254,0,255,255,0,0,255,0,85,0,253,96,0,0,255,0,0,255,0,255,0,255,0,2,0,255,0,255,0,28,0,254,0,255,254,9,0,0,0,255,255,0,0,255,0,6,0,254,0,255,2,0,235,0,0,0,0,255,255
0,218,255,0,26,0,0,0,11,0,0,26,255,0,0,54,255,12,239,0,255,0,255,255,255,0,0,255,0,255,255,212,1,255,0,4,0,255,255,0,63,255,3,220,0,255,255,255,0,3,45,27,67,0,1,4,255,255,89,0,255,0,255,1
210,251,251,4,0,0,1,0,0,0,0,0,8,255,254,0,44,255,0,0,0,0,254,0,255,255,255,0,0,217,255,0,255,239,255,0,0,0,0,255,243,255,250,0,255,241,249,15,0,2,24,0,0,255,0,194,0,1,213,58,255,1,0,14
253,59,253,249,255,255,255,255,255,255,232,255,255,255,255,0,255,214,255,255,255,255,238,255,255,0,0,255,215,0,253,49,255,48,0,0,255,225,0,255,255,255,234,0,255,0,0,255,0,0,255,0,255,255,34,250,255,255,0,0,255,250,3,255
0,0,0,201,16,29,15,255,10,0,0,2,205,193,255,0,1,0,0,0,1,255,44,0,0,0,0,255,255,252,111,0,241,0,21,0,0,0,0,0,0,0,27,0,254,0,0,0,0,0,254,9,37,255,0,255,0,255,255,0,0,255,255,20
248,240,2,27,254,255,0,243,255,255,255,80,252,255,43,0,9,255,255,14,165,255,255,58,58,17,255,0,0,0,0,0,82,5,0,0,251,205,252,151,1,255,255,23,255,251,251,0,255,0,255,0,255,0,255,253,0,238,255,0,169,255,255,27
251,255,1,0,222,132,249,1,5,0,9,207,0,0,0,205,36,255,255,156,12,1,249,1,26,253,255,165,0,13,6,4,254,255,12,0,0,1,2,0,16,252,105,0,104,0,246,0,72,0,28,0,0,16,255,233,2,14,205,47,225,222,136,66
