17,6,5,6,2,8,6,10,8,8,8,6,4,8,6,11,12,13,15,9,8,13,12,18,17,13,19,12,13,14,14,17,21,17,19,13,11,16,18,20,22,15,12,7,3,10,7,9,7,7,6,3,1,4,4,3,2,2,2,1,2,3,4,5
22,21,6,25,3,38,33,25,50,40,8,38,11,51,34,30,69,52,13,57,19,60,30,34,43,51,12,53,16,38,13,39,39,56,11,48,15,60,23,37,44,46,8,28,7,74,39,40,75,48,7,27,5,53,19,5,6,4,1,3,2,3,3,3
55,59,94,88,75,98,126,130,86,113,79,87,76,93,87,87,53,95,74,89,101,108,99,92,67,96,77,74,93,74,92,87,87,92,99,77,80,73,102,97,78,85,101,73,76,106,122,123,58,110,55,83,57,95,96,60,9,26,8,20,22,4,5,2
37,43,76,19,84,66,22,35,113,89,98,48,129,82,20,33,102,75,88,35,126,54,25,37,83,55,88,23,87,23,22,19,73,53,74,16,93,40,22,20,90,88,96,34,151,105,22,27,113,86,115,37,171,108,21,34,83,27,61,26,42,5,2,3
48,16,51,110,104,75,46,10,103,12,39,84,122,67,30,9,103,9,33,83,134,72,41,16,101,20,59,75,104,30,58,20,122,25,88,95,120,55,61,19,120,17,51,111,155,122,52,9,126,13,33,125,151,79,18,3,71,4,7,31,26,2,2,1
26,19,15,106,73,157,148,60,66,26,8,122,94,155,112,44,60,18,9,126,115,129,124,69,108,55,21,123,99,96,98,54,69,44,22,107,86,109,118,38,62,23,11,109,113,196,151,64,78,27,6,160,130,172,160,53,77,6,2,26,37,6,4,1
69,64,74,72,29,57,66,14,132,85,75,95,55,68,64,8,106,50,49,76,32,34,70,23,115,83,75,78,64,46,76,23,123,62,93,72,46,48,75,14,127,63,69,98,29,66,85,10,124,99,66,114,32,57,94,4,67,49,32,59,31,1,3,1
28,44,54,20,29,50,69,119,39,40,63,20,51,59,85,112,29,22,55,18,29,28,46,79,27,26,37,26,32,33,57,66,28,29,38,15,33,37,67,103,40,54,67,23,35,89,98,137,34,79,105,24,40,73,103,100,28,22,98,32,48,8,8,3
37,19,57,66,54,74,94,101,48,62,110,72,73,115,79,80,32,59,74,56,62,52,48,76,57,51,99,67,86,50,90,84,80,32,110,61,92,84,95,105,59,65,97,79,42,129,101,101,35,100,102,107,41,99,67,74,13,83,120,71,46,11,5,2
33,31,34,64,14,55,96,50,72,100,76,110,43,106,110,49,81,72,59,77,31,31,48,28,65,36,49,67,54,46,65,33,54,42,57,67,50,73,95,38,88,86,52,89,14,122,122,70,120,144,80,147,50,141,154,69,86,119,103,142,56,27,21,3
71,75,93,55,48,32,98,142,53,94,54,48,58,42,119,117,52,106,29,36,38,21,57,80,52,88,73,57,64,46,99,86,61,80,95,54,62,36,89,84,49,82,60,52,51,37,130,147,38,103,25,87,48,40,82,126,12,129,22,99,31,13,17,2
36,49,81,32,71,88,12,24,100,90,117,58,110,110,19,40,104,67,98,45,90,43,12,25,66,64,90,45,97,85,35,23,76,80,86,37,112,86,16,29,80,85,111,33,84,138,15,43,117,138,131,102,127,160,12,34,108,114,131,106,125,21,5,5
51,19,34,119,76,102,49,5,108,8,25,124,97,105,41,6,94,9,17,86,58,57,59,10,84,11,45,109,113,64,82,13,98,8,40,103,114,90,37,8,105,8,29,113,73,128,36,10,117,9,13,148,96,170,19,8,114,12,18,126,62,9,3,1
22,19,15,104,89,161,116,19,30,8,6,94,80,169,108,34,45,11,5,112,81,144,92,29,25,13,11,96,96,152,100,30,30,16,10,106,97,142,103,22,51,13,3,87,87,164,147,28,58,18,5,110,126,189,120,32,83,14,8,100,103,24,9,2
58,63,53,90,31,75,41,8,113,31,48,90,27,50,42,7,112,54,45,89,46,47,59,17,114,43,71,86,57,68,93,19,144,57,89,82,36,30,42,6,100,78,66,95,19,63,84,6,147,83,62,138,19,57,26,3,53,60,37,128,49,2,2,1
28,35,50,23,30,72,85,98,24,23,35,17,30,51,70,90,29,20,37,15,40,36,62,72,36,20,37,19,41,48,84,89,41,43,45,18,29,28,55,90,17,36,61,20,24,107,158,192,47,147,147,68,46,123,133,119,15,30,89,43,45,5,3,2
26,17,38,77,44,103,90,87,29,52,81,58,77,93,103,115,56,60,105,69,84,63,83,83,65,29,94,61,89,74,109,108,76,59,98,68,54,66,71,72,33,39,98,71,23,128,100,152,25,152,154,136,23,95,34,76,6,67,69,62,36,6,1,1
25,28,34,76,26,99,103,34,66,47,68,67,40,51,75,27,80,62,87,94,57,62,75,42,67,47,55,70,49,67,75,54,83,76,70,89,31,84,85,28,49,49,26,47,6,101,129,68,111,146,75,94,22,106,55,20,43,57,40,95,47,4,3,1
40,67,75,62,74,50,92,125,26,63,28,48,63,32,111,94,58,84,60,54,56,45,89,91,47,75,75,40,61,30,100,103,62,101,79,45,36,29,68,86,36,57,56,42,29,31,106,178,28,115,8,88,32,32,36,112,6,84,2,50,14,1,1,0
26,41,71,47,107,123,20,26,87,74,99,68,106,91,21,37,84,83,102,52,108,75,25,30,55,56,70,31,89,62,23,22,83,84,93,26,113,91,9,20,98,122,111,43,97,146,4,42,118,163,145,100,115,143,1,21,92,69,82,74,44,2,0,1
40,22,37,116,82,136,47,8,101,8,15,91,67,63,63,11,98,8,28,100,94,71,69,15,91,17,51,108,119,66,78,14,118,12,41,138,130,132,67,6,103,5,30,127,93,150,18,7,95,4,7,170,58,119,3,1,37,2,3,91,27,1,0,0
17,12,12,102,80,173,139,28,51,10,7,86,90,117,92,19,42,12,7,99,95,132,93,35,39,22,13,90,81,123,86,25,35,14,9,113,131,200,156,25,42,9,2,61,55,126,48,15,46,4,1,91,91,182,65,13,32,3,1,43,86,6,1,0
44,52,52,95,32,60,47,5,81,44,41,85,45,38,59,15,136,57,67,98,52,59,83,24,122,61,77,82,62,53,77,14,129,45,83,93,37,53,99,8,157,73,80,85,5,10,13,1,63,21,14,111,10,39,17,0,17,26,14,75,29,0,0,0
24,34,56,25,27,68,58,118,32,27,60,26,37,42,87,112,47,34,45,25,37,46,70,81,49,34,42,24,46,41,65,85,34,40,46,18,34,71,112,140,37,87,93,17,13,52,85,135,14,75,84,35,23,145,158,70,9,19,51,23,32,2,1,0
24,16,47,85,54,94,77,75,31,60,87,69,64,55,80,94,74,52,117,71,79,73,98,117,95,48,111,59,103,65,118,95,76,44,109,81,80,130,113,123,51,108,100,73,23,82,69,105,8,94,93,125,14,146,65,65,2,70,71,58,29,2,0,0
30,23,28,48,16,51,87,28,57,50,59,62,29,32,68,34,95,49,54,60,34,47,76,37,73,45,65,62,65,53,75,32,83,44,61,56,27,83,105,52,89,121,54,74,11,73,84,40,76,73,34,81,19,183,87,64,40,113,63,129,39,4,2,0
54,63,84,53,56,38,92,114,49,82,44,45,49,30,99,79,77,85,81,55,62,41,99,95,44,96,89,56,90,58,117,101,72,73,79,37,34,20,94,135,36,87,39,53,47,30,79,111,16,50,4,84,27,25,58,136,4,78,2,60,14,1,0,0
39,48,78,35,76,96,19,39,90,73,104,48,94,51,24,34,78,81,103,41,87,79,22,27,62,68,96,46,117,99,28,35,70,91,92,34,97,100,9,31,94,119,105,49,119,153,5,32,73,153,114,75,66,99,1,8,98,68,78,84,59,2,0,0
44,20,38,97,76,111,60,11,93,9,36,93,91,50,66,18,115,11,54,105,104,85,59,13,101,8,31,107,100,69,62,11,101,7,30,96,80,99,57,8,116,6,14,129,88,154,24,6,62,7,15,158,41,94,4,1,61,2,3,99,18,1,0,0
25,20,24,100,82,151,140,29,39,14,11,101,92,101,90,22,42,15,8,71,93,116,114,27,35,10,6,89,91,129,115,23,40,9,4,77,77,142,98,21,32,8,2,79,109,201,140,20,36,11,2,75,52,102,14,7,36,3,1,36,66,3,1,0
63,58,69,76,35,58,74,20,130,55,72,105,70,70,89,17,127,63,91,96,45,57,75,16,133,58,73,104,67,57,79,13,144,59,74,109,29,38,60,5,122,61,54,108,37,67,96,5,137,100,47,58,1,1,0,0,5,10,4,35,9,0,0,0
32,49,64,32,33,53,78,99,40,27,46,25,55,49,87,116,50,52,64,20,28,51,100,126,46,38,50,25,53,50,95,135,42,52,68,20,37,69,94,129,33,48,74,24,38,105,136,172,25,138,136,10,2,5,8,8,2,8,21,13,19,1,1,0
40,24,56,79,60,64,85,80,58,32,98,73,87,83,92,96,71,46,110,64,40,81,77,87,39,73,93,71,75,81,98,111,76,59,111,86,63,118,82,101,31,59,96,73,70,150,101,132,15,116,108,61,1,9,4,10,2,70,57,40,14,1,0,0
38,28,30,50,24,47,88,36,55,34,59,84,54,58,91,37,78,63,47,38,8,33,79,43,97,58,65,93,45,61,110,50,91,82,53,91,32,91,111,44,86,62,53,90,30,130,122,54,79,123,59,39,3,34,22,14,44,76,62,77,24,2,2,0
71,72,68,51,43,45,71,107,56,70,78,60,72,45,95,80,60,95,77,48,21,13,53,115,39,124,40,60,64,43,122,137,68,101,56,51,44,33,78,114,30,64,33,53,50,40,94,148,14,97,12,46,18,10,45,80,9,83,4,50,10,0,0,0
35,43,74,37,80,91,29,38,79,56,92,52,107,93,37,33,84,111,122,45,63,69,5,27,90,93,114,77,122,108,26,50,126,110,127,55,105,113,6,25,81,82,111,55,124,166,7,32,98,149,152,70,86,89,2,13,94,100,106,91,48,2,0,1
44,22,34,98,72,80,36,7,73,6,39,140,124,105,77,16,109,22,48,122,35,34,8,2,48,5,14,114,93,116,56,16,133,10,26,124,98,149,21,5,89,5,16,119,97,148,33,5,93,7,14,140,38,124,16,3,96,7,13,125,18,1,0,0
24,17,16,101,73,120,104,21,28,7,8,101,97,153,121,32,56,29,8,85,39,26,9,2,7,4,5,89,125,166,123,41,62,13,4,82,85,147,77,14,38,7,2,118,118,187,133,27,42,11,2,98,64,200,104,31,56,9,6,91,108,10,2,1
59,54,51,72,28,75,38,11,115,38,72,98,52,84,90,16,127,91,64,84,10,2,2,0,13,22,50,129,64,104,68,15,140,79,58,102,17,38,28,3,98,58,46,107,22,75,83,5,144,123,72,117,16,44,49,2,96,78,58,118,27,1,1,0
28,34,45,24,31,51,74,91,41,26,47,23,51,71,78,80,29,42,53,21,25,15,29,20,10,15,38,34,56,89,119,161,60,78,91,29,30,54,83,116,16,45,70,22,29,82,110,136,28,82,105,20,48,62,97,104,19,27,86,35,45,7,6,3
28,16,44,76,53,84,86,85,45,42,83,74,87,96,101,85,63,47,86,68,26,20,18,32,16,40,69,71,61,129,90,139,45,93,103,86,49,102,85,86,25,71,80,85,35,119,81,113,28,130,125,92,40,94,84,78,14,70,84,63,35,14,5,2
39,22,26,57,21,92,113,47,63,48,62,109,60,105,108,43,80,80,60,79,28,51,66,18,37,47,39,97,29,90,92,57,111,120,87,108,50,120,127,38,80,65,39,66,14,61,74,50,86,143,82,143,37,129,131,67,73,87,73,104,52,21,19,3
67,68,80,57,67,52,103,110,59,83,66,66,69,51,107,94,61,97,87,64,43,30,54,66,25,71,40,58,44,46,109,147,49,98,34,55,45,31,99,108,29,73,24,53,30,12,63,122,27,107,20,75,34,32,99,121,18,94,16,61,22,7,12,2
42,45,76,27,93,86,28,37,83,67,101,50,105,96,26,35,95,98,106,39,117,82,13,25,84,82,86,67,127,126,14,44,123,117,129,56,118,121,12,38,96,102,111,60,102,90,5,26,104,126,122,70,111,138,8,37,107,107,103,105,98,24,7,5
44,19,43,95,111,99,70,16,100,10,40,113,116,103,65,14,116,13,37,104,119,111,47,10,99,14,39,119,112,115,36,12,136,13,23,122,95,159,61,13,117,12,31,121,79,84,31,7,114,10,17,114,77,159,35,8,97,12,19,110,38,14,5,1
31,25,22,110,78,160,130,38,34,12,9,96,95,138,112,30,45,18,11,122,88,163,123,39,48,20,9,124,101,149,82,25,53,17,6,127,116,193,155,51,64,17,5,106,73,106,68,15,39,12,6,109,99,194,120,43,46,10,9,77,100,42,20,3
77,67,68,87,38,84,77,22,122,48,67,69,40,37,54,13,109,45,63,84,48,52,86,15,130,77,82,101,41,34,45,6,108,67,48,108,33,78,99,13,120,84,68,90,17,9,22,4,95,49,51,95,28,73,72,10,116,59,54,93,52,14,11,2
34,43,58,25,38,59,74,105,52,33,50,19,25,36,50,76,26,25,39,20,37,54,76,80,37,33,60,20,44,35,51,104,28,34,58,23,42,76,101,155,41,66,94,24,36,28,57,107,29,46,61,25,43,75,105,121,38,31,55,37,67,31,31,8
42,19,65,70,81,80,118,98,70,38,108,64,73,70,72,76,50,40,96,82,82,105,120,104,63,56,100,86,76,95,88,98,54,65,109,96,87,160,120,128,56,85,123,79,57,72,52,94,41,85,106,83,82,133,117,111,42,79,82,70,51,44,24,6
43,39,30,72,24,62,91,38,54,46,56,38,28,34,46,24,54,34,53,76,64,86,95,40,75,64,75,91,56,61,96,35,83,61,69,109,49,119,148,63,103,120,80,76,25,37,74,33,102,71,57,110,51,100,102,56,70,57,78,91,53,48,48,7
88,64,82,53,51,32,100,95,56,63,69,32,44,22,78,74,69,89,81,55,56,52,107,93,60,100,77,55,63,43,108,100,54,89,73,67,42,33,112,139,35,113,42,46,31,16,66,94,46,91,35,50,56,43,109,118,26,106,38,62,36,29,40,5
38,42,72,24,59,72,21,25,63,61,86,28,67,52,23,29,71,73,90,40,88,96,36,35,75,60,98,46,129,111,25,38,93,102,123,55,128,128,13,38,109,119,124,65,97,83,8,36,98,88,121,68,120,143,16,31,97,95,111,86,104,50,27,10
53,20,57,107,101,88,77,13,79,11,38,102,93,60,66,13,89,13,48,114,108,85,88,13,92,8,42,124,118,98,75,11,101,10,38,122,108,123,47,10,127,10,17,108,58,70,23,5,72,5,20,108,99,131,71,9,101,15,25,106,64,39,26,3
31,23,24,89,75,142,117,26,27,14,12,81,76,123,92,29,34,16,14,96,85,157,108,31,30,10,9,100,117,157,116,24,43,17,7,99,95,162,114,33,48,14,5,84,82,121,93,18,31,11,6,113,114,189,118,40,36,15,16,81,97,72,47,6
79,56,63,83,33,69,78,23,128,43,77,80,47,47,72,18,119,46,80,91,65,72,90,20,114,55,91,106,55,61,86,15,139,66,75,113,38,65,71,10,113,78,63,91,28,34,36,11,135,58,61,108,67,107,105,17,113,72,65,106,69,31,29,4
33,35,52,22,33,53,74,78,45,28,44,20,38,44,80,56,27,22,35,22,49,52,85,86,49,34,56,21,41,45,99,120,55,54,72,30,54,71,117,146,37,63,90,31,45,49,103,120,43,37,54,25,53,79,111,92,50,34,60,49,67,42,47,8
43,21,48,60,69,65,88,73,57,29,74,60,87,53,98,71,57,35,88,74,95,77,104,102,70,31,98,72,76,81,87,112,60,76,104,88,59,122,85,121,35,99,91,67,43,64,43,73,31,62,106,77,84,108,112,92,52,68,68,59,56,44,30,6
36,27,27,55,33,57,62,33,53,27,58,49,54,59,69,27,48,31,61,68,61,75,89,44,71,51,71,67,44,75,81,52,84,78,85,96,50,89,106,65,88,86,82,88,46,54,74,43,90,68,72,95,59,90,88,65,75,47,63,73,60,49,49,7
69,79,64,48,60,50,73,105,85,87,66,37,65,36,73,65,65,69,71,50,58,42,93,85,65,83,80,38,50,39,80,105,57,117,62,53,53,25,79,136,41,100,22,26,27,20,53,91,84,112,40,40,68,36,109,110,64,117,53,57,54,40,54,8
23,31,71,42,88,87,38,31,67,50,98,61,92,88,51,24,53,38,73,50,87,87,43,37,72,57,96,49,119,111,33,39,99,92,135,107,149,130,19,43,109,88,120,85,93,58,11,37,100,59,114,75,102,92,25,33,83,51,106,71,103,64,38,12
27,20,51,105,104,91,76,10,55,17,36,89,93,93,90,13,56,18,51,89,102,81,77,18,68,16,55,102,99,132,83,15,77,26,42,129,75,137,67,14,88,18,22,73,38,53,37,10,84,20,47,102,89,82,73,11,80,19,35,77,69,46,35,5
15,29,35,154,114,176,87,40,21,21,35,113,97,156,77,35,21,19,29,85,93,133,63,35,21,24,28,113,95,176,78,33,14,25,21,128,92,162,51,30,18,17,22,83,59,98,30,20,15,20,33,108,84,107,59,29,20,13,19,63,81,95,60,14
36,43,68,105,75,77,75,19,44,20,71,75,64,66,80,20,49,26,81,71,62,57,75,28,61,32,80,74,42,46,63,10,27,19,59,65,26,30,46,7,18,10,30,46,21,30,43,13,34,24,67,82,54,48,76,19,43,18,51,54,42,46,61,16
21,14,23,17,62,36,44,22,32,10,30,17,56,24,28,17,35,13,29,18,53,26,36,21,37,15,32,19,57,32,35,16,27,9,26,15,62,28,32,14,22,7,26,12,55,18,31,17,35,15,35,23,67,38,36,23,38,10,26,14,52,15,14,11
